WWWWWWWWWWWWWWWWWWWWWWWWWWWWWWWW
WWWWWWWWWWWWWWWWWWWWWWWWWWWWWWWW
WWWWWGGGVGGGWWWWWWWWWWWWWWWWWWWW
WWWWWGGGVGGGWWWWGVVVGWWWWWWWWWWW
WWWWWGGGVGGGWWWGGVVVGGWWWWWWWWWW
WWWWWVVVWWWWWWGGGVVVGGGWWWWWWWWW
WGGGGGGGGGGGGGGGGWWWGGGGGGWWWWWW
WGGGGGGGGGGGGGGGOWWWOGGGGGWWWWWW
WGGGGGGGGGGGGGGGGWWWGGGGGGWWWWWW
WWWWWGGGWWWWWWGGGGWGGGGWWWWWWWWW
WWWWWGGGWWWWWWWGGGWGGGWWWWWWWWWW
WWWWWGGGWWWWWWWWGGWGGWWWWWWWWWWW
WWWWWWWWWWWWWWWWWWWWWWWWWWWWWWWW
WWWWWWWWWWWWWWWWWWWWWWWWWWWWWWWW
WWWWWWWWWWWWWWWWWWWWWWWWWWWWWWWW
-
00000000000000000000000000000000
00000000000000000000000000000000
00000000000000000000000000000000
0000000000L000000000000000000000
00000000000000000000000000000000
00000000000000000000000000000000
00000000000000000000000000000000
00PT00000000000000000000R0000000
00000000000000000000000000000000
00000000000000000000000000000000
000000L000000000L000000000000000
00000000000000000000000000000000
00000000000000000000000000000000
00000000000000000000000000000000
00000000000000000000000000000000
-
00000000000000000000000000000000
00000000000000000000000000000000
00000000000000000000000000000000
00000000000000000000000000000000
00000000000000000000000000000000
00000000000000000000000000000000
00000000000000000000000000000000
00000000000000000000000000000000
00000000000000000000000000000000
00000000000000000000000000000000
00000000000000000000000000000000
00000000000000000000000000000000
00000000000000000000000000000000
00000000000000000000000000000000
00000000000000000000000000000000