WWWWWWWWWWWWWWWWWWWW
WGGGGGGGGGWGGGGGGGGW
WGGGGGGGGGGGGGGGGGGW
WGGGGGGGGGGGGGGGGGGW
WGGGGGGWGGGGGGGGGGGW
WGGGGGGGGGGGGGGGGGGW
WGGGGGGGGGGGGGGGGGGW
WGGGGGGGWGGGWWGGGGGW
WGGGGGGGGGGGGGGGGGGW
WWWWWWWWWWWWWWWWWWWW
-
00000000000000000000
00000000000000000000
00000000000000000000
00000000000000000000
00P0T00000000R000000
00000000000000000000
00000000000000000000
00000000000000000000
00000000000000000000
00000000000000000000
-
00011111111110000000
00111111111110000000
01111111111110000000
11111111111110000000
11111111111110000000
11111111111110000000
11111111111110000000
01111111111110000000
00111111111110000000
00011111111110000000