WWWWWWWWWWWWWWWWWWWW
W000000000000000000W
W000000000000000000W
W000000000000000000W
W000000000000000000W
W000000000000000000W
W000000000000000000W
W000000000000000000W
W000000000000000000W
WWWWWWWWWWWWWWWWWWWW
-
00000000000000000000
00000000000000000000
00000000000000000000
00000000000000000000
00P0000000000000R000
00000000000000000000
00000000000000000000
00000000000000000000
00000000000000000000
00000000000000000000
-
00011111111111111000
00111111111111111100
01111111111111111110
11111111111111111111
11111111111111111111
11111111111111111111
11111111111111111111
01111111111111111110
00111111111111111100
00011111111111111000