WWWWWWWWWWWWWWWWWWWWWWWWWWWWWWWW
WWWWWWWWWWWWWWWWWWWWWWWWWWWWWWWW
WWWWWGGGGGGGWWWWWWWWWWWWWWWWWWWW
WWWWWGGGGGGOWWWWGGVGGGWWWWWWWWWW
WWWWWGGGGGGGWWWGGGVGGGWWWWWWWWWW
WWWWWWWWWGGGWWGGGGVGGGWWWWWWWWWW
WWWWGGGVVGGGGGGGGWWWWWGGGGWWWWWW
WWWWGEGVVGGGGGGGOWWWWGGGGGWWWWWW
WWWWGGGVVGGGGGGGGWWWGGGGGGWWWWWW
WWWWWWWWWWWWWWGGGGGGGGGWWWWWWWWW
WWWWWWWWWWWWWWWGGGGGGGWWWWWWWWWW
WWWWWWWWWWWWWWWWGGGGGWWWWWWWWWWW
WWWWWWWWWWWWWWWWWWWWWWWWWWWWWWWW
WWWWWWWWWWWWWWWWWWWWWWWWWWWWWWWW
WWWWWWWWWWWWWWWWWWWWWWWWWWWWWWWW
-
00000000000000000000000000000000
00000000000000000000000000000000
00000000000000000000000000000000
000000L0000000000000000000000000
00000000000000000000L00000000000
00000000000000000000000000000000
00000000000000000000000000000000
000000000000000000000000T0000000
00000000000000000000000000000000
00000000000000000000000000000000
00000000000000000000000000000000
00000000000000000000000000000000
00000000000000000000000000000000
00000000000000000000000000000000
00000000000000000000000000000000
-
00000000000000000000000000000000
00000000000000000000000000000000
00000000000000000000000000000000
00000000000000000000000000000000
00000000000000000000000000000000
00000000000000000000000000000000
00001110000000000000000000000000
00001110000000000000000000000000
00001110000000000000000000000000
00000000000000000000000000000000
00000000000000000000000000000000
00000000000000000000000000000000
00000000000000000000000000000000
00000000000000000000000000000000
00000000000000000000000000000000