WWWWWWWWWWWWWWWWWWWW
WGGGGGGGGVGGGGGGGGGW
WGVGGGGGGVGGGGGGGGGW
WGGGGGGGGVGGGGGGGGGW
WGGGGGGWGVGGGGGGGGGW
WGGGGGGGGVGGGGGWGGGW
WGGGGGGGGGGGGGGGGGGW
WGGGGGGGWGGGWWGGGGGW
WGGGGGGGGGGGGGGGGGGW
WWWWWWWWWWWWWWWWWWWW
-
00000000000000000000
00000000000000000000
00000000000000000000
00000L00000000000000
00PT00000000000T0000
00000000000000000000
00000000000000000000
00000000000000000000
00000000000000000000
00000000000000000000
-
00011100000000000000
00111100000000000000
01111100000000000000
11111100000000000000
11111100000000000000
11111100000000000000
11111100000000000000
11111100000000000000
11111100000000000000
11111100000000000000