WWWWWWWWWWWWWWWWWWWWWWWWW
WGGGGGGGWWGGGWWWWWWWWWWWW
WGGGGGGGWWGGGWWWWWWWWWWWW
WGGGGGGGWWGGGWWWWWWWWWWWW
WGGGGGGGWWVVVWWWWWWWWWWWW
WGGGGGGGWOGGGGGGGGWWWWWWW
WGGGGGGGVGGGGGGGGGOWWWWWW
WGGGGGGGVGGGGGGGGGGVVGGGW
WGGGGGGGVGGGGGGGGGGVVGGGW
WGGGGGGGVGGGGGGGGGGVVGGGW
WGGGGGGGVGGGGGGGGGGWWWWWW
WGGGGGGGWGGGGWWGGGWWWWWWW
WGGGGGGGWGGGGWOGGGWWWWWWW
WGGGGGGGWGGGGGGGGGWWWWWWW
WWWWWWWWWWWWWWWWWWWWWWWWW
-
0000000000000000000000000
0000000000000000000000000
00000000000L0000000000000
0000L00000000000000000000
0000000000000000000000000
0000T00000000000000000000
0000P00000000000000000000
0000000000000000000000000
0000000000000000000000R00
0000000000000000000000000
0000000000000000000000000
0000000000000000000000000
0000000000000000000000000
0000000000000000000000000
0000000000000000000000000
-
0000000000000000000000000
0000000000000000000000000
0000000000000000000000000
0000000000000000000000000
0000000000000000000000000
0000000000000000000000000
0000000000000000000000000
0000000000000000000000000
0000000000000000000000000
0000000000000000000000000
0000000000000000000000000
0000000000000000000000000
0000000000000000000000000
0000000000000000000000000
0000000000000000000000000
0000000000000000000000000