WWWWWWWWWWWWWWWWWWWW
W000000000000000000W
W000000000000000000W
W000000000000000000W
W000000000000000000W
W000000000000000000W
W000000000000000000W
W000000000000000000W
W000000000000000000W
WWWWWWWWWWWWWWWWWWWW
-
00000000000000000000
00000000000000000000
00000000000000000000
00000000000000000000
00P0000000000000T000
00000000000000000000
00000000000000000000
00000000000000000000
00000000000000000000
00000000000000000000
-
00011111111110000000
00111111111110000000
01111111111110000000
11111111111110000000
11111111111110000000
11111111111110000000
11111111111110000000
01111111111110000000
00111111111110000000
00011111111110000000