WWWWWWWWWWWWWWWWWWWWWWWWW
WWWWWWWWWWWWWWWWWWWWWWWWW
WWWWWWWWWWWWWWWWWWWWWWWWW
WWWWWWWWWWWWWWWWWWWWWWWWW
WWWWWWWWWWWWWWWWWWWWWWWWW
WWWWWWWWWWWWWWWWWWWWWWWWW
WWWWGGGVVGGGGGGGGGOWWWWWW
WWWWGEGVVGGGGGGGGGGGGGGGW
WWWWGGGVVGGGGGGGGGGGGGGGW
WWWWWWWWwGGGGGGGGGGGGGGGW
WWWWWWWWWWWWWWWVVVWWWWWWW
WWWWWWWWWWWGGGVGGGWWWWWWW
WWWWWWWWWWWGGGVGGOWWWWWWW
WWWWWWWWWWWGGGVGGGWWWWWWW
WWWWWWWWWWWWWWWWWWWWWWWWW
-
0000000000000000000000000
0000000000000000000000000
0000000000000000000000000
0000000000000000000000000
0000000000000000000000000
0000000000000000000000000
0000000000000000000000000
0000000000000000000000000
0000000000000000L00000T00
0000000000000000000000000
0000000000000000000000000
0000000000000000000000000
00000000000L0000000000000
0000000000000000000000000
0000000000000000000000000
-
0000000000000000000000000
0000000000000000000000000
0000000000000000000000000
0000000000000000000000000
0000000000000000000000000
0001111100000000000000000
0001111100000000000000000
0001111100000000000000000
0001111100000000000000000
0001111100000000000000000
0000000000000000000000000
0000000000000000000000000
0000000000000000000000000
0000000000000000000000000
0000000000000000000000000