WWWWWWWWWWWWWWW
WWWWWWWGGGGGGGW
WWWWWWWGGGGGGGW
WWWWWWWGGGGGGGW
WWWWWWWWWWWGGGW
WWWWWWWGGGVGGGW
WWWWWWWGEGVGGOW
WWWWWWWGGGVGGGW
WWWWWWWWWWWWWWW
-
000000000000000
000000000000000
00000000L000T00
000000000000000
000000000000000
000000000000000
000000000000000
000000000000000
000000000000000
-
000000000000000
000000000000000
000000000000000
000000000000000
000000111110000
000000111110000
000000111110000
000000111110000
000000111110000