WWWWWWWWWWWWWWWWWWWWWWWWWWWWWWWWWWWWWWWWWWWWWWWWWWWWWWWWWWWW
WWWWWWWWWWWWWWWWWWWWWWWWWWWWWWWWWWWWWWWWWWWWWWWWWWWWWWWWWWWW
WWWWWWWWWWWWWWWWWWWWWWWWWWWWWWWWWWWWWWWWWWWWWWWWWWWWWWWWWWWW
WWWWWWWWWWWWWWWWWWWWWWWWWWWWWWWWWWWWWWWWWWWWWWWWWWWWWWWWWWWW
WWWWWWWWWWWWWWWWWWWWWWWWWWWWWWWWWWWWWWWWWWWWWWWWWWWWWWWWWWWW
WWWWWWWWWWWWWWWGGWWWWGGWGGGGWWWWWWWWWWWWWWWWWWWWWWWWWWWWWWWW
WWWWWWWWWWWWWWWGGGWWWGWWWWGWWWWWWWWWWWWWWWWWWWWWWWWWWWWWWWWW
WWWWWWWWWWWWWWWWGWWGGGWWWGGOGGWWWWWWWWWWWWGGGVVVGOGWWWWWWWWW
WWWWWWWWWWWGGGWGGWGGWWWWGGWWWGGWWWWWWWWWWWGGGVVVVVVWWWWWWWWW
WWWWWWWWWWWGWGGWGWGWWWWGGWWGWWGWWWWWWWWWWWGGGWVVVVVWWWWWWWWW
WWWWWWWWWWWWWWGGOGGGGGGWGGWGOWGWWWWWWWWWWWWWWWVVVVVWWWWWWWWW
WWWWWWWWWWWGWWGGWGWWWWGGWGWWGWWWWWWWWWGGGVGVGWOVVVGWWWWWWWWW
WWWWWWWWWWWGGGGGWGWWGWWGWGWWGWWWWWWWWWOGGVGWGWGVVVVWWWWWWWWW
WWWWWWWWWWWWWWWWWGGGGGWOGGWWGWWWWWOWWWGGGVGWGGGVVVVWWWWWWWWW
WWWWWWWWWWWGGGGWGGGWWWWGGWWGGWGGGGGGGGGGWWWWWWWVVVGWWWWWWWWW
WWWWWWWGGGGGGWGGGOWWWGGGWWWGWWGGGGGGGGGGGVGVVGOGGWVWWGGGWWWW
WWWWGGGGGGGGWWGGGGWWWWGGWWGGWOGGGGGGGGGGGVGVVVVVGVVVVGGGWWWW
WWWWGGGGGGGGWWGGWWWGGGGWWGGGWGGGGGGGGGGGGVGGGGVVGWVWWGGGWWWW
WWWWGGGGGGGGWWGGWWWGWWWWGGWGGGGGGGGGGGGGGVVVGVVVVGGWWWWWWWWW
WWWWWWWGGGGGWWWGGWWGWWGGGGWWWWWWWWOWWWGGWWWWGWWWWWVWWWWWWWWW
WWWWWWWWWWWGWWWGWWGGGWWWWGGGGWWWWWWWWWGGGGGWGGGOGWGWGGGWWWWW
WWWWWWWWWWWGGWWWWGGWGGGGWGWWGOWWWWWWWWOGGGGWVVVVVWGWGGGWWWWW
WWWWWWWWWWWGGGGWWGGWWGWGWGGWGWWWWWWWWWGGGGGWWWVVVWOVGGGWWWWW
WWWWWWWWWWWGGWGGWOWWGGWWWWGGWWWWWWWWWWWWWWWWWWGGGWWWWWWWWWWW
WWWWWWWWWWWGOWWGWWWWWGWWWWWGGWWWWWWWWWWWWWWWWWGGGWWWWWWWWWWW
WWWWWWWWWWWGWWWGWWWWWGGGWWWWGGWWWWWWWWWWWWWWWWGGGWWWWWWWWWWW
WWWWWWWWWWWGWWGGWWWWWGWGGGWWOGWWWWWWWWWWWWWWWWWWWWWWWWWWWWWW
WWWWWWWWWWWGGWWWWOGGGGWGWGGGGWWWWWWWWWWWWWWWWWWWWWWWWWWWWWWW
WWWWWWWWWWWGGGWWWWWWWWWWWWWWWWWWWWWWWWWWWWWWWWWWWWWWWWWWWWWW
WWWWWWWWWWWWWWWWWWWWWWWWWWWWWWWWWWWWWWWWWWWWWWWWWWWWWWWWWWWW
WWWWWWWWWWWWWWWWWWWWWWWWWWWWWWWWWWWWWWWWWWWWWWWWWWWWWWWWWWWW
WWWWWWWWWWWWWWWWWWWWWWWWWWWWWWWWWWWWWWWWWWWWWWWWWWWWWWWWWWWW
WWWWWWWWWWWWWWWWWWWWWWWWWWWWWWWWWWWWWWWWWWWWWWWWWWWWWWWWWWWW
-
000000000000000000000000000000000000000000000000000000000000
000000000000000000000000000000000000000000000000000000000000
000000000000000000000000000000000000000000000000000000000000
000000000000000000000000000000000000000000000000000000000000
000000000000000000000000000000000000000000000000000000000000
000000000000000000000000000000000000000000000000000000000000
000000000000000000000000000000000000000000000000000000000000
000000000000000000000000000000000000000000000000000000000000
000000000000000000000000000000000000000000L00000000000000000
000000000000000000000000000000000000000000000000000000000000
000000000000000000000000000000000000000000000000000000000000
000000000000000000000000000000000000000000000000000000000000
000000000000000000000000000000000000000000000000000000000000
000000000000000000000000000000000000000000000000000000000000
000000000000000000000000000000000000000000000000000000000000
000000000000000000000000000000000000000000000000000000000000
00000P00T000000000000000000000000000000000000000000000R00000
000000000000000000000000000000000000000000000000000000000000
000000000000000000000000000000000000000000000000000000000000
000000000000000000000000000000000000000000000000000000000000
000000000000000000000000000000000000000000000000000000000000
000000000000000000000000000000000000000000L0000000000L000000
000000000000000000000000000000000000000000000000000000000000
000000000000000000000000000000000000000000000000000000000000
00000000000000000000000000000000000000000000000L000000000000
000000000000000000000000000000000000000000000000000000000000
000000000000000000000000000000000000000000000000000000000000
000000000000000000000000000000000000000000000000000000000000
000000000000000000000000000000000000000000000000000000000000
000000000000000000000000000000000000000000000000000000000000
000000000000000000000000000000000000000000000000000000000000
000000000000000000000000000000000000000000000000000000000000
000000000000000000000000000000000000000000000000000000000000
-
000000000000000000000000000000000000000000000000000000000000
000000000000000000000000000000000000000000000000000000000000
000000000000000000000000000000000000000000000000000000000000
000000000000000000000000000000000000000000000000000000000000
000000000000000000000000000000000000000000000000000000000000
000000000000000000000000000000000000000000000000000000000000
000000000000000000000000000000000000000000000000000000000000
000000000000000000000000000000000000000000000000000000000000
000000000000000000000000000000000000000000000000000000000000
000000000000000000000000000000000000000000000000000000000000
000000000000000000000000000000000000000000000000000000000000
000000000000000000000000000000000000000000000000000000000000
000000000000000000000000000000000000000000000000000000000000
000000000000000000000000000000000000000000000000000000000000
000000000000000000000000000000000000000000000000000000000000
000000000000000000000000000000000000000000000000000000000000
000000000000000000000000000000000000000000000000000000000000
000000000000000000000000000000000000000000000000000000000000
000000000000000000000000000000000000000000000000000000000000
000000000000000000000000000000000000000000000000000000000000
000000000000000000000000000000000000000000000000000000000000
000000000000000000000000000000000000000000000000000000000000
000000000000000000000000000000000000000000000000000000000000
000000000000000000000000000000000000000000000000000000000000
000000000000000000000000000000000000000000000000000000000000
000000000000000000000000000000000000000000000000000000000000
000000000000000000000000000000000000000000000000000000000000
000000000000000000000000000000000000000000000000000000000000
000000000000000000000000000000000000000000000000000000000000
000000000000000000000000000000000000000000000000000000000000
000000000000000000000000000000000000000000000000000000000000
000000000000000000000000000000000000000000000000000000000000
000000000000000000000000000000000000000000000000000000000000