WWWWWWWWWWWWWWWWWWWWWWWWWWWWWWWW
WWWWWWWWWWWWWWWWWWWWWWWWWWWWWWWW
WWWWWWWWWWWWWWWWWWWWWWWWWWWWWWWW
WWWWWWWWWWWWWWWWWWWWWWWWWWWWWWWW
WWWWWWWWWWWWWWWWWWWWWWWWWWWWWWWW
WWWWWWWWWWWWWWWWWWWWWWWWWWWWWWWW
WWWWWWWWWWWWWWWWWWWWWWWWWWWWWWWW
WWWWGGGVVGGGGGGGGGOWWWWWWWWWWWWW
WWWWGEGVVGGGGGGGGGGGGGGGWWWWWWWW
WWWWGGGVVGGGGGGGGGGGGGGGWWWWWWWW
WWWWWWWWwGGGGGGGGGGGGGGGWWWWWWWW
WWWWWWWWWWWWWWWVVVWWWWWWWWWWWWWW
WWWWWWWWWWWGGGVGGGWWWWWWWWWWWWWW
WWWWWWWWWWWGGGVGGOWWWWWWWWWWWWWW
WWWWWWWWWWWGGGVGGGWWWWWWWWWWWWWW
WWWWWWWWWWWWWWWWWWWWWWWWWWWWWWWW
-
00000000000000000000000000000000
00000000000000000000000000000000
00000000000000000000000000000000
00000000000000000000000000000000
00000000000000000000000000000000
00000000000000000000000000000000
00000000000000000000000000000000
00000000000000000000000000000000
00000000000000000000000000000000
0000000000000000L00000T000000000
00000000000000000000000000000000
00000000000000000000000000000000
00000000000000000000000000000000
00000000000L00000000000000000000
00000000000000000000000000000000
00000000000000000000000000000000
-
00000000000000000000000000000000
00000000000000000000000000000000
00000000000000000000000000000000
00000000000000000000000000000000
00000000000000000000000000000000
00000000000000000000000000000000
00000000000000000000000000000000
00001110000000000000000000000000
00001110000000000000000000000000
00001110000000000000000000000000
00000000000000000000000000000000
00000000000000000000000000000000
00000000000000000000000000000000
00000000000000000000000000000000
00000000000000000000000000000000
00000000000000000000000000000000