WWWWWWWWWWWWWWWWWWWWWWWWWWW
WWWWWWWWWWWWWWWWWWWWWWWWWWW
WWWWWGGGGGGGWWWWWWWWWWWWWWW
WWWWWGGGGGGOWWWWGGVGGGWWWWW
WWWWWGGGGGGGWWWGGGVGGGWWWWW
WWWWWWWWWGGGWWGGGGVGGGWWWWW
WWWWGGGVVGGGGGGGGWWWWWGGGGW
WWWWGEGVVGGGGGGGOWWWWGGGGGW
WWWWGGGVVGGGGGGGGWWWGGGGGGW
WWWWWWWWWWWWWWGGGGGGGGGWWWW
WWWWWWWWWWWWWWWGGGGGGGWWWWW
WWWWWWWWWWWWWWWWGGGGGWWWWWW
WWWWWWWWWWWWWWWWWWWWWWWWWWW
WWWWWWWWWWWWWWWWWWWWWWWWWWW
-
000000000000000000000000000
000000000000000000000000000
000000000000000000000000000
000000L00000000000000000000
00000000000000000000L000000
000000000000000000000000000
000000000000000000000000000
000000000000000000000000T00
000000000000000000000000000
000000000000000000000000000
000000000000000000000000000
000000000000000000000000000
000000000000000000000000000
000000000000000000000000000
-
000000000000000000000000000
000000000000000000000000000
000000000000000000000000000
000000000000000000000000000
000000000000000000000000000
000111110000000000000000000
000111110000000000000000000
000111110000000000000000000
000111110000000000000000000
000111110000000000000000000
000000000000000000000000000
000000000000000000000000000
000000000000000000000000000
000000000000000000000000000