WWWWWWWWWW
W00000000W
W00000000W
W00000000W
W00000000W
W00000000W
W00000000W
W00000000W
W00000000W
WWWWWWWWWW
-
000000000J
00000000I0
0000000H00
000000G000
00000F0000
0000E00000
000D000000
00C0000000
0B00000000
A000000000
-
1000000000
0100000000
0010000000
0001000000
0000100000
0000010000
0000001000
0000000100
0000000010
0000000001