WWWWWWWWWW
W00000000W
W00000000W
W00000000W
W00000000W
W00000000W
W00000000W
W00000000W
W00000000W
WWWWWWWWWW
-
0000000000
0000000000
0P00000000
0000000000
0000000000
0000000000
0000000000
0000000000
0000000000
0000000000
-
1000000000
0100000000
0010000000
0001000000
0000100000
0000010000
0000001000
0000000100
0000000010
0000000001