WWWWWWWWWW
W00000000W
W00000000W
W00000000W
W00000000W
W00000000W
W00000000W
W00000000W
W00000000W
WWWWWWWWWW
-
0000000000
0000000000
0P00000000
0000000000
0000000000
0000000000
0000000000
0000000000
0000000000
0000000000
-
0001111000
0011111100
0111111110
1111111111
1111111111
1111111111
1111111111
0111111110
0011111100
0001111000