WWWWWWWWWWWWWWWWWWWWWW
W00000000WWWWWWWWWWWWW
W00000000WWWWWWWWWWWWW
W00000000WWWWWWWWWWWWW
W00000000WWWWWWWWWWWWW
W00000000WWWWWWWWWWWWW
W00000000WWWWWWWWWWWWW
W00000000WWWWWWWWWWWWW
W00000000WWWWWWWWWWWWW
WWWWWWWWWWWWWWWWWWWWWW
-
000000000J0000000000J0
00000000I00000000000J0
0000000H000000000000J0
000000G0000000000000J0
00000F00000000000000J0
0000E000000000000000J0
000D0000000000000000J0
00C00000000000000000J0
0B000000000000000000J0
A0000000000000000000J0
-
1000000000010000000000
0100000000010000000000
0010000000010000000000
0001000000010000000000
0000100000010000000000
0000010000010000000000
0000001000010000000000
0000000100010000000000
0000000010010000000000
0000000001010000000000