WWWWWWWWWWWWWWWWWWWW
WGGGGGGGGGGGGGGGGGGW
WGGGGGGGGGGGGGGGGGGW
WGGGGGGGGGGGGGGGGGGW
WGGGGGGGGGGGGGGGGGGW
WGGGGGGGGGGGGGGGGGGW
WGGGGGGGGGGGGGGGGGGW
WGGGGGGGGGGGGGGGGGGW
WGGGGGGGGGGGGGGGGGGW
WWWWWWWWWWWWWWWWWWWW
-
00000000000000000000
00000000000000000000
00000000000000000000
00000000000000000000
00000000000000000T00
00000000000000000000
00000000000000000000
00000000000000000000
00000000000000000000
00000000000000000000
-
00000000000000000000
00000000000000000000
00000000000000000000
00000000000000000000
00000000000000000000
00000000000000000000
00000000000000000000
00000000000000000000
00000000000000000000
00000000000000000000