WWWWWWWWWWWWWWW
WWWWGGGGGGVGGGW
WWWWGGGGGGVGGGW
WWWWGGGGGGVGGGW
WWWWWWWGGGWWWWW
WGGGGGGGGGWWWWW
WGGGGGGGGOWWWWW
WGGGGGGGGGWWWWW
WWWWWWWWWWWWWWW
-
000000000000000
000000000000000
00000L000000R00
000000000000000
000000000000000
00PT00000000000
000000000000000
000000000000000
000000000000000
-
000000000000000
000000000000000
000000000000000
000000000000000
000000000000000
000000000000000
000000000000000
000000000000000
000000000000000