WWWWWWWWWWWWWWWWWWWWWWWWWWW
WWWWWWWWWWWWWWWWWWWWWWWWWWW
WWWWWGGGVGGGWWWWWWWWWWWWWWW
WWWWWGGGVGGGWWWWGVVVGWWWWWW
WWWWWGGGVGGGWWWGGVVVGGWWWWW
WWWWWVVVWWWWWWGGGVVVGGGWWWW
WGGGGGGGGGGGGGGGGWWWGGGGGGW
WGGGGGGGGGGGGGGGOWWWOGGGGGW
WGGGGGGGGGGGGGGGGWWWGGGGGGW
WWWWWGGGWWWWWWGGGGWGGGGWWWW
WWWWWGGGWWWWWWWGGGWGGGWWWWW
WWWWWGGGWWWWWWWWGGWGGWWWWWW
WWWWWWWWWWWWWWWWWWWWWWWWWWW
WWWWWWWWWWWWWWWWWWWWWWWWWWW
-
000000000000000000000000000
000000000000000000000000000
000000000000000000000000000
0000000000L0000000000000000
000000000000000000000000000
000000000000000000000000000
000000000000000000000000000
00PT00000000000000000000R00
000000000000000000000000000
000000000000000000000000000
000000L000000000L0000000000
000000000000000000000000000
000000000000000000000000000
000000000000000000000000000
-
000000000000000000000000000
000000000000000000000000000
000000000000000000000000000
000000000000000000000000000
000000000000000000000000000
000000000000000000000000000
000000000000000000000000000
000000000000000000000000000
000000000000000000000000000
000000000000000000000000000
000000000000000000000000000
000000000000000000000000000
000000000000000000000000000
000000000000000000000000000